XXXXXXXXXXXXXXXXXXXX
X//////////////////X
X//////////////////X
X//////////////////X
X///////E//////////X
X//////////////////X
X//////////E///////X
X/////////////E////X
X//////////////////X
X//////////////////X
X//////////////////X
X/E////////////////X
X///////////E//////X
X//////////////////X
X//////////////////X
X//////E///////////X
X//////////////////X
X//////////////////X
X//////////////////X
XXXXXXXXXXXXXXXXXXXX